100 100
#.##.##....##....#...#.#.####.#...#.#.#.....#.##.....#.#..###..##...##...#...#...#.##.##.#...##.....
###...#.#..##..##.#.....#.#..###.###..#..#.#.#.#....#.#.##.####...#..####..#.#..#.#.#...#..####.#...
#..#..##...#####..#....#..#.#.###........###.##.##....##..##...###.#..##.#.#.#....#..##...###.#.#..#
#.#......###....#.#..#.#...####..########..####.#.#.......#..#.#..##..####...#......#.#######.######
...#..#...#.#....#...####......#...#.###.##..#.#.....#..#.##..#.###.....###..##.#......#.#.##.#.##..
#.##.##.###.##......##.##.#.#...#.....#..###....#.##..#####...##.####........#.###...##.#.#.###.#...
...#.#.#..#####..#...####.##....#..#..#.#.###....##..##...###.####.##.##...####.#...##.#.#.#.##.##..
#.#.#.####.##...##.##.#...###.#.##.#.##..#.###..#.#.#.##.##.#.#.#....##...##..#......##.###...######
.#.#.##.#...#..#####........##.#.#..#..##.#.#.###.#.#.....#..#.###.....###.#.#.......#.#..##....####
..#.#...#..##.......#.....#.#.#..##........##..##.#.###.##.###.#.#..#..####.##..#..###....#####..#..
.#.....#.#....##..#.###..#.###.......##.#.#.#....##.##.##.###...#..###.#.....###...#.###.#.###.##.#.
#...#.##...#.##...#...#####...#...###.###....#..#.#.##.##...#.......####..#.#.#.#.##.#..#..#....#.##
##.#..#.#..#..........###..#.#..####.##.#..###.#.##...#.#.##.######.#.##..#....##....##..#..#.#.#...
...#.#...#..#.#.....##.###....###.#..##.##.....#..#.#.##..#.#.#.#...#.####..###.#.#.##...#.....#..#.
##...#..##.#####..####.###...##...##..######...##....#...#..#.######...###.#..##.##...##.##....#....
..#.#..##.#.###.......#.#....#.#....#...#.#..#..#...####....##...###.#..#.##...#...#.....#..#####..#
.#.##...##...#.#...##.##..#..##......#.#.####.###..#..##.....#..#.#..#..#.##......#..#.###..###.#.#.
..#..#.##..###.#.#....##..###..#....#...#..###.#.#.#...#...###.##.####...#....#...#...#.#.###..##...
.#.##.#..##.##.##..######............##.#.#..#.#.....#.#..#....####.##.#.##..####.........##.#......
#.##...##..##.###.#...#.#...######...#....##.##.#####....#..#.#.....#..#....#.#..#.....#.###....#.##
#####.###..#....##..####..#...##.###.#.....###..#.#.#.#.####..#.#...#....#....###.#.#..##..##.#...##
######.#...#....###..#.#..#.#.##.###.#.....##.#......#....##.###.##...#..####.....##..##...#....#...
..#.###.##.#..###..#..#####...#......###...#..#.#.#....#######..##.....##..#.##...#...###...#.#..#.#
.##....##..#.....##.#.#...#.##.#.####..##.#...##..##....#...#.##.#..........##...##.#..###..#...#...
..##..#......####...#.#..##..####.#...##...#..#.###....##.#..###.#.#.#..#..#..##.#...#...#.####.##.#
....###.#.##.#.###...#.......####..###.#.##.##.##.######.#...####.#.#..##.##..##...#..#....#..####.#
..##..##...##..##...####.#.#...#....#.#....#.##..#.#.##.#.####.#.####..#....#.#....#.#.##..##.#.#.#.
.###.....###..#.##.#.#..#...#####.....##....#.##...##.#....######.##..##..#.##.##....#.##.#.#...##.#
#...###.#..####.....#.....#####....##.#..#.#.#..####..#..#.#...#...#.##..##.#.#..#.....####.#.###..#
...##...#...#...#.#....###..####.##..###......#..#..######....##.#..#..####...##...#..##..#####..#.#
#.###.#.#.#..#..###.#....#.###....#.#..#...#..########...#.#..#.#...###..#...#####...#....#.#..###.#
.####.##..#..#.#...#...##...#.....##....#..#..#.#..#######...#.....######.##.##..#.......#......##..
######..##.#.#..#..#.#...#....#.#......#.##.##...##.#..#..######....#..##.#..#..##.##..#.###...#....
###..#..##...##.#...#.##.#....#.#.##.#.##.##....#.##....##.#..######..#..#.##....#.#....#.#.##...##.
.#...##.#.#.#.###..#..#.##.#.....#...###....#...##.#..........####......#....###.###..#.###..##..###
###..#.#####......#....#..#.##.##......#....###.##.#...##...#...#.#.####...#.#.##.##..#....#......##
#...#######.#.##...##.#..###..###..##...#.##.##...#.##..#######.#.####...####.####..#....##...##.###
......##..#.#.#..##.#.....#..#####.#.#....#.###...###......##...#....#.#..#..##.#...#....##..#...#.#
.#..###...###.#......#...#....###.##.#.##..##.#####..#...#..#........##.#...#..#...#....#..#.#...##.
#.#.#..##........##..#...###.#.####.####.##...##..###...#.#...###...#..#.##.#..#.##.#.###..#####.##.
#.#.########.#........#...#.#..##.##..###.####.#.#........#....#..##...#.......#.#...#.#.#.#.#..###.
..####..#..#.#.#....####......#....#.#..#..#...#.##.#.#.#....##.#..#....##..#.......##...#..##..#.##
....#.###..#..#.##.####...#..####.##...#.#####.##.#..#.#..#.##.#####.##.###.##.....##...##..##.#..#.
#.###....#.......#.###..##...........#...#.#...##.#.#...#.#.#.####..#..###.#.#.#.###.#.##...###.#.#.
.##..#.####.##...##.#.##.####..#..####...##.##....###..#.##.......#....##...###.#..#.##.....####....
.#..#.#..#..###.#....##.#.#.####.###.##.#..#..##.#.##.########......#..#....#.###.###..##..#...#....
.#..#....#.#.##....##........##.#..#....##.#########..###.#.#.####....#..####..####.#.#.......###...
#..#...#....##...##........##....###.#.#..##.####..#....##...#......###.##.###...####....#.#.#.##.##
#....#..##...###..#.#.###.###.......##.##.#.###.....#..###...##.#......###.#..#....#.###..###.#..#..
#.#...##.#...####.#....#..#...##..#.#..##.........#....#.#...#..##......#.###.#...###.###....#....#.
.......#..#.####.#.#..###...##.##..#.#.####...#..#..#.#...##.............#.#####....#.#.#..#....#.#.
#.###.#.###..#.#.#.###.#..#..#.#.##...#.#.##.##...#..##.#.#..#..##...#.###..#...#######..#..##....#.
##.#..#.#..#.....#..##.#.##.##...#.#.#.....#.###......#..#..#.###.#...#.###..####.....#..#...#.#.#.#
#.#.####.....#.#..#.#.##.#.......###.....#.......##.#..........#.##..####..#.......#..#..######...##
...#..##..#.....##.#.#......#.##.###.#..#....##.#..##....###.###......###.##.##...#...#.#..##..###..
.##.#.###.#.####....##.##..###.......#.#...##.#...#.#.....#.#..#.#.#.#.....#.##.##.##..........#...#
....###.##.######..##.#..##..#.###..###..##..#.##..###........###.####.#.##.#.##....#..###.....#..##
.#..#.......#......#....##..######...#..####..##..#..#..##.#.##..#..#..#.#..##.....#.##....####.....
.#...#....##.#..##..#..##..###...######...####..#####..##..#..#.##...#..#########...##..##.#..#.#.#.
..#.#...#.#.#.#...##....##.##..#.#...#..##...#..#.#.........##...#..#.....#.......##..##..#.#.##.#.#
.#..#.##.#..###...#.#.####..........#.##...#####..#..###..#.#......#.#.#.#...#...#..##.#...#.##...#.
###.##....###.#.###.#..##.#..#.#..#...##....##..#..#..###....#.#..##..#..#......######.#.##.#..##.#.
##..##.....###....#.##.##.##..##...##..##.##..#..######..#.####.##.##.#..#..###.#....##.###.#...###.
#.###.##..##..#.##.#..#...##....#...##.####.##.###...#...#.###....#.##.#...#.#..#.....#.##.#...#####
.....##.##.#.###.....##..##..##..##..#......#.#...##..#.#...............##...#...#....#.#.#.#...#...
#.#..#.#.##.#....#....#.#..#..#.#.....##...#.#.##.#...#......#...###....#.#.##......#####....#.#####
.#######.##.##.#...#.#.#....#.###...###..##.#.#####..#.#.....####..#.#...#.....##.####...#####...##.
.......##.########..#.###.##.###.#..######...##.#..#.##.#..##......##.##.##..#.##..##..##.##.#######
#..#.###.##...###.####..##..#...#####........#...####.##....###.#...#.#..#.#...#...#.#.#...#....###.
#.#.#.#...##.....#.#..##.#...##.#.##....#.........##....#.#..##.#..#.#.#...##..#........#.####...#..
.#.##.#.##.....#..#...#..#.#..###.#..###.#..#.###.###...#.#..##.###...######.#.##..#.##.#.#..#.#....
.#..###.#.####.####....#.#.#.######.....##..#..##...#........###....###.....#..#..#..##.....#.#.#...
.###..#...##....#..#.#....#.....####.#.#....####...##.#...#..#.#.######.##....#....#......##...#..#.
.#.#...##.....#####.##..#.#####.#....##...###..#......####....#.#.##..##..##.....##..###....##.#.#..
.#....##.#.##.#....####.#.#####...#.....##..#.....#.#..#..##...#####...##.#...#..#..#.##..#...##.#.#
.#....###.######...#.....#.#####.###..##.#...#..#......######.#...#.#..#..##...#.#.#.#....#.#....###
#######....#..##.#..##..###.#..###.#..###..#####...###.#...#.#.......#.###.#.#.......##.#.#.#..###.#
...#...#..#....#.####...#..#.###..###....##...#..#.#..####..##....#.#....#.#.#.#....#..###.#...#..#.
#.#.#..#.#..##.#.#..###..#.####....#....#..######.##.....##...#.#....#.#..#.#....#.#...###..##.....#
###..#####...#####.##...#.##.....#.#..###...#.#.##.#..####...####..##.#..#.##.##.##.###....#..#.#...
...##...#.#...#####.#.#.#..##..##..##.#..#....###.#.#...##.#..#.#.........#.#.#.#...#..#..##.#...###
.###.##....#.#....###.##.######...##.##........##.#.##.#..###.#.#.#...##...####...##..#.#........#.#
...###...#......###.#..####...##.#..#....###.#..#..####.####...##.#...##...##.#..#####.###.....####.
.####...#..#..#...#...#####...###...#.....##...##..#.##......###......##..#..#.##..###...#.....##.##
##...##.#.##.#.#.......#.#...###....#.####.##....#..##.##....#.###.......###.#.##..#..##.#...##..##.
.######....#..#########.#..#......#.#....##...#....#.#.#..#..#..#..##.##.###.#.##.#...##......##..##
......#....#....#....#..#..##....##...#.#.##...#.##..#..##...##....##...#.#....#..#.##.##..#..#....#
##..#..#......#..#.###.##.#.#....#.#.#....##..###.#....#.#...###.....###.##..#...###.#.#...#.#.##.#.
#......##.....#....#..##.#.#.#...###.##.##....#...#.#..#....##..##.#...#.##...###.....#.##.....##.##
.....##.#.....#.##.#....#.#....#.#..#..#..#..#.##.#.#..#.#.....#.##..#..#.#.#......##.#.#.#..#.#..##
.....#.#.#..#.####.###.....##..#.##.#.#..#........#...##....#####.###.#..#.#.#.##.........#.##..#.##
#..#.#.#..#.#.#..##..#.#....##.##.....#.#.##......#...#.#.....#####...#...#.##..####.####...#..##.#.
.#..#....##.#...##...#.#..##.####..........##.###........#.#..#..#####.##.##......###.#..###.....###
##..#.#.##....#..#..#...#.#......#.#.###...#..#...#.#.......##...#..#....###.##.##...#..#..##..####.
#..##...##..#.#...#.#..#..#.#.###...#..#..#.#....####.##..#.........###..##.#....##...#.#.#..###....
###.##....###.........####...#####...##.#...#..#.##.#.#.....#......##.#####.##..#.####..#...##.#.#..
#..#.###.##.........#..##.......#.#..##.#..####..#..###.##.######.....#.#...#....####.##..#.....##..
.##.......##....#...##...#.#.#.#.#...........#..#.#....#.....##.#..##.##..####..####...##.##..##....
.##.#.#.##....#.#..##.#######...##.##.#..#..#.#..######.###.##..#.##.#...##.#.####.##..#.....##.####
.#.###..##....###..#..####.#####.....#..#..#.#..#.###...#.#.#..#.#..###..###..####..#..#......##....
