100 100
..#.....#.#...#..#.####..#.####.#.###.#....#.#..#...##..#..##.######........#...#.#.###..#..#.#.#...
#.#.#######...#..###.##.#.#...#####.#.##.##..##.#..#...########.##.#.##....##......###...##..#####..
.#..#.#...##....#..##.##.###....#..###...##..#.#.......#.#.###.#.###.#.#....#.##..#..####.#.#...#.##
....#..#.#.#...###..####.#.#...#..#.#.#.##...##...#..#....#.#......##..#.#.#.#...##..#.#.#..#.##..##
.###.##.#.#.....##.#..##.#..#..####.....#..###...#..####.#...##.#.......##.#.##.#...######..#..#..##
.##..##..#..#.##.###..##.#.#..##.#..#.#.##..#.#.###.####.#...#.##..####.....#.#.....#.#..##.#...###.
#.#...###.##...#.....##....####.#...#..#....##.#........###....###..#..##.....###.##...##...##...#..
#.##......#..####.#.#.###.##.#.#..#.##....#.##....##..###.#...#...##...##..#..#......#..#..#.#..###.
#..#....#.##.#####.#..###.....##.#..#....#..##.##..#.#....#...#.#.#..#.###.#.#.##.#####.#..#...#...#
#.##...#..####...#.#....######...###.##..#....#....#.###...#.#...#........#.#.....#.....#.##..##....
...#..#..##..#.##...###.#.####.##..##.###..#.#..#..#....#.###....##.###.#..#...#.#....###.###.#...#.
###.###.#.#.#...#..#.#......##.#.#.#.##..#..###..#.####..#.###..###..#..##...#....#....#.#..##.##.##
#....##...#.#.###.#..#.##.#....#....#.#...##.#.###.##......###......##..#....#..#.##.####..#..#.....
..##.#.#....#.##.##.##..####.#.###.#..##.#...##.##..##.##.....#.....###......#.####.####.###.###....
###.....##.####.#...###.##...#.##....#..###.#.....#.#....###..#.#.#....#..###...#......##.#..#..##.#
..#.####.#..##.#..###....#...####.................##.#..##.###..##..##.###.#######......###......##.
.###..##.###.##...#.#..###.....#..##.#......#.##.##......#..##..#####.#...####....##..........#..#..
....#.##.#.#...#........##...#...#.##..##.#....#..#.##.#....##..#####........#.###.#.#..##...##...#.
.##.#..###.#...#...#.#...#.#..##...........#.####.##...##..#...#.#.....##.#....##.#..#....#.##.#.#..
.##.#.....###..##.....######.#####..#.#.###...#.#.#....#.###.##.#.#....##..##.#.##..##.##.#.######..
.....#..#.#.#....##..##..#.#..#......##.#...#.#..#.#....#.#.#.#.#....#.....#..#####..#.#.....###...#
..#.....###..#..##.#####.#...###.##.##.#.....##...#...#..##..###.##.#.#....#.#.#.##....#.........###
#....#..#.##.#..#..###.##...###.#...#.#...#.#..###..##..#..#.##.....#.##.##....#..##..#....#.#...###
..###..##..###.#.###.#.#.#.##.###.##..##.####..##...##.#....#..#.##..##...##.....#.##.#..##.#####...
..#..##.#####......#.....##..#...##...#..##.######..#.#..###.##.#..##..#..#####.#...........###.####
#..###...#.##....###....##.#.....#.#..#.###.###..##..#.....#.#.###..#.#.#.####.#.##...#.##.#.#.###.#
...####...##.#..###...###..#..######..####..##.#.##..#.###....######..##...##..###.##....#..##.#....
..##.##..#..##....##.#......#.#.#..######..######.##.#.####...##.......#.#...#.#..#.##....#...##...#
##...##..######...####.###.#.#..#.####.#..#..#.......#..###..........#.#..#.....###.#..###..##..##.#
#.#....####....##.##....#..#....#..#.#..######...###...#########.#.###..###..####..##...#..#....#.#.
###.....#.#.##.#...####.#####.#.#....#..#..#.#..#..#....#.##..#.#.........###.##.####...#..##..####.
###.....###.#..##...##........###...#...#..#..###.....##....#..##.....##.#.######.#.##...##...##....
#####.##.#........#...#######.###.#...##.#..##..#.####..##...#..#..###..##..##.#....###..##.#.##..#.
.##.#..#...#..#...##..........##.###...##.##.#..##..##...##..#...#..###.##.#.#..#..#.#..#...#....#..
#..##.#.##..####.#.#.#.#####.##..#...#.#.#...#...#...###.#..###...##..###.##..#####..##.####...#.###
##..##.#.....##...#.#..#.##..#.###.#.....###...###...##.###....##..#...#..#...#..#.#....#...###.....
.######...#.#..#.#...##..##.#..#..#....#...#.#..#.##..####.####..#..#..#....#.#.##...#.....######..#
###.#....###.#.....##.##...#.#....#.#.#.#.#..#.........##..##..##..#...##.........#.#.#...##.##...#.
####.##..##.##.#......###.#.#..#######.#...#...###.#.###.#......#.#..###.#.#.#.##..###.####...#...#.
..#.##..##.#....###....#...#.#.......##.......###..#####....#....#.##...#...#.##.#.##....#####.#.#..
.......#.......#.##.##..###.#..#.#.#.##.##....###..#.#.#.#.##.#####...#.##.#..#.#........#.....##...
..#.....##.#...#...#...###..#.#####.....##.##.#.#.#..##.####..##.#..#.#..#....#..##.#.####...#.....#
..#..#...#...###.......###.#..#.###....##...##.#..#.#..#.##...#..###..#.###...##....#.#.#####.###..#
..#..###......#...##.#.##..#.#..#.#...##.##.###..#..#...###.#.....#....###....#..###.##..##.##.##.##
..#..##......#.#.#...#.######..##.##.#.#.###.#.#######.....##...#..##..#..###..#.#....#...#.#......#
###.#.#....#..#.##.....##..###....##..........###...#..#.##.#.#...##..#.....#..##.#.#.#..###....###.
###..#..##...#..#..##......#####...#.#.#.#.##.......#...#.#.##....###.##.#.##..######....#.###...##.
.#.#...##.##.###.##.##.#####....#.######.#..#..##......##...###...#.###...#.######..#...#..#.#.####.
#.##.###.#..#.##.#####.#####.####..##..##.....#..##..###..#..#....#.#.......###.###.##..##.#.#..#..#
.#.###...##.####...#.#.....####.#....##.#.......#.#....##..####....#.#.#####..##....#.###..###..#...
.########..#.##.##.....#...#...#....#..#.#.#..#..####.#....#..##.#.....#.#####.#.#..#####.######..##
....##..#.###..##..####....#..#.#.#....##.#....#.#..#.##.#..##########.##.#.#.##.#...#######.#.####.
#.#..#...#.....##.##.#..###....#.#.#...####...#..#...##....#.##.#.###..#.#...###.....#...#.###..##..
..#..#..#...#.#.#..#.#.#.#..#....#..#.....######...#..###...#.###....#...#....###.#..###..#...#...##
.#..#....#....#####.##.###...#.###...##...#.###......##.####..#....#....#......#.....###.###....#...
..####.####..#.#..#.#.#.......#..#..###.##..#.##.#.####..##.#.....#.##..#####...##.#....##....#.....
#...###..##...#...####.#.###...#..##..#....#..##.#.####.#.##...#.##.....###..###...##.#...##..#...#.
##.....###.####..##.#.#........##.##..#...#..#...#...###...##.##.##.##.##.#........###..#.......#...
.#.#.#...###...#...#.####.##....#..###.#.....#...#...#..#..#.##........#...#...##.##..#.##.####..#..
.#.....#..#...#...##..##.#..#.###..##.#..###..###..######...##....##..###.#####..##..##.#..#...#.###
.#..#..####.#.###..#....#...#..#.....#.##....#....####.##.##..###......###.#.....##..####.#..#.#..##
..#..##.#.###.....#..#.....#.##..###.#.#...##...#######.#....###...#...#...###.#..####.##.#.##.#.#.#
########....#######.##.###.##.#..#.###....####..##..###..####.####.##......#..#..##.#.#.#.##.#.#..##
#####..#..#.#..##..#.#.#.##...#..#....#...#.....#.....##.#...#..##.###.#.#.##..#.#.#.##.##..##..####
..#..#.#..#.#.#..#.#.###....####.#.#..#.#...##.#.#.#.####..#####.#.#.#.##..####...##....#...#.#...#.
#.#..#.#....##.......#.#.##.....#.#..#..#...####.#.#..#....###..###..#####....#.#..#.....#.#####.#..
#...#...##....###..#.###.#...###...#..#.#.##.#...#.#..#.#....####.#.#####.#..#..#.#.####...###.#.##.
...###.#.####..#..#.##...#..####.#.......###.####.#.#.#...###.#..#.###..##..#####...#.##.......#.#..
........#.#...##.#.#....####....#.#....###...#.......#..##.##...#.#.#.#.##..#.##..#..#...##..###...#
.##.#.#..##..#.#####.#######..#.#......#.#.#..##..###.#..###.###..#..#...........#...#..####..#..##.
.#.##.....#.###...#######.##...###.##..#.#.#..#.#.##..#..#.##...#....#.....#...##....#..#.#.....##..
..#####..#..###.##.#.....#...#.##.#.#..........#..#.........##.###.##.#.#.......##...#....###.####..
#..###.#.###.####...##...##.#.##..#..##...#..#..###.###.##...#..#..##.....#.....##....#..#....#....#
..#.#.##.###.##.####.....#...##.#.###.#.##.##...####....#..#...#..#.....#.####.##...#.###....#.###.#
...#.#.#.#.##..##.#..##.###...###...#..#.#.###.#.##...#...#..##....#.#..#...###..##.#...#..##..#..##
#..#..#..#####.......###.#..#.#.#.#.##...#.#...#...#..####......##..###..#.##.....#..#.##.#.########
.##...#..####..#......#..##.##..##.###.##.#..##....#.###..##..####.#....#..##...#...#...#......#....
.#..#.##..####.##.#.....#...###..#######....###..#...#...###..#.#....##..#.##..##.......#.....#.....
.#......######.#...#...#.#....###..##...#..#...#.#...#.##..##.#..##.###.#......#..#.#..#.###.#..#..#
..#..###....#.#..#########..###..#.#.........#..#.#..##.....#....#.#...##.#.##.#.......###..#.......
#......##.#.#...#.##.....##...#....#...#.#..#####...#........##...##.....###...#.#...#..##..#...####
##..##.#..#.........#.#.#.......##.#.##...#####....#..#.###...###.###...########...#####...#...##..#
#.#..#.#..##..#..#..........##.###...####..#......#.....#.#.#.####..#...#.#.#.#......##......##.....
..#.##.##....#..##..#..##....#.#.##.##.####...##...#.#...#...##.##..##.#......###..##.###.#...#.#.##
#.#.#.......#..#######.#....####.##.#..#.####..#.##...#..#..#..###.......#..#..####.#....#.####.##.#
#.##.#..#.##.#.....##.....#.##..##...##..###.#.#..#.####....#.##.#...##..##.#.#.#..#........##..####
..#.#.###.#.#.#####.###..#.#..###....#..#####.#.##....#...##.#.##...#..#.###.#####.#..#.##.##...##..
##.##...#.#.##.##.....##..#....##..##.####.........#..####.....###...##..#.###..#..........#.#....#.
.#.##..#....##.########..#......#..#...#....##.###.##.#....###....##.##..#......#..####....##.......
.#..#..##..###.###..#.##..#..#.#..##...#..###.#.#####.#...#..####.#...#..####.....##.....##.#.....##
#####.#..##.....#.####.###..###........##..#....#..##.#.###....###..##..#.##...#.#........#####...##
##.##.#..#.########...#.###..#..##.#.#........#....#.##.#........#........#..#..###.#.###...###.#..#
#....#......#..###...#..#.##..#......#...##.#..#.#.#.#.#.####.#.##..##.#.....#..#....#.#...#####....
##.##..#..##.#.#.#....#..#.#..#...###.....####..###...#.##.#####...#..#...#####.#.#.##.##.#.#.....##
.....######.#.###.#.#..#.#.#..##..#..#.#########..##.##.#.##.....###.....#..##....#.#.#...##.....###
...###..#...#..#...##..#......#.###.####...####.##..#...##....##..###..#.#..##.....##.#....#.#..#.##
.#..#....#.#..#.#####....##.#.#......#....####.#########.#.#...#.###.###..#..##....#.##..#...##.###.
...##.##.#...#.#####...########.#.##.##.#.#...##.##...####..#.##......###...#..###......#...##..#.#.
.####.......#.#.#..####...#..#.#......##.#####..#..####.#...#.###....##...##.##.#...##.#....####...#
.###..#......##.#..#.##...#....#.......#####...##.#####.#...#......#.####.#####..######...#.#.#..#..
