100 100
#...#.#..##.##.###.#...#.#.##.......#.#...#..##..#..##.#.##.....#.#######..######.##........##.###..
.##...#.##...#...#.#.#.##.#.#...#.#..#..#.##..#.##.....#.#.##..####...#..#...##.##...##.##.###.#..##
###.#.#####.##....#.#..##...#...##....#..##.###....##..#....###..##..##.##..##..#......#...#..#.#.#.
#.###...####...######......####..#..########..#.##..#.#..#.......##...#.....#..###.#..#....#...#.##.
.##.#####.#.#.####.#.#.#....#.#.#.#.#.#.#.#....#..###.....###.#.###....#.#..##......#...#..#....#...
.##..##.##..#..#..#......#.#.##.#.##...#.#..##.##.#.#.#.##.#....#.##.#.#.#...#.#..#####...##........
...###.#####.#.########.###.#..#####..#.###.#....#.#.##.##.#.#..###..##.##....#.#..#.....##..#.##.#.
#.#####.##.#######...####..#...#.#.##.#...#.#####...###.....#.#...#..#####.##...#..#####....#####.#.
#....#.#....##.#...##.#...##..#.#.###..#.##.###.......#..#####..#####.#..##......###.###.......##.##
.#....#....########.#..###.##.#..#..##..#.##.####.....#.#..###...##..#..##..#.#...#...####...#.###..
.#..##..#..##..#.......##..........##.###..#....##.##..#.#.##.##...#.###......##.#...##.##.#.#.##.#.
#..###.#######.##...#....#......###....##....###..#....#..###....####..#......##.#.#.#..#.##.#..#...
#.....#.#...#.###...#..##..#.####.####...#......#.#.##.###....#.####...##...#.#.###...##.####.#.#...
###...#..#######...###...#.....###.#....#.#...#........##.###.#####.#.##..#.##...#..####.##...#..#..
#.###.......##..#.#.....##.##..###.##.....#.#..#.##..#..#..##.....##...#####..#...##...#.##..##..###
.#.#####.##.#..#.##.####..#.#.......#........#..#.#.######.##.#.....###.##...#..#.####.##.#.#.###...
..####.#..#.###.##..#...###....#...#.....#....###.##........#.##.#.....#....#..#...##.#.##.#....##..
##...#..#...#..##......#.#........#...#.....#.######....#...#..#....##.####.###.#.......#.##.##..#..
.......#.###.....###.##....###.#.....###...#..##.#.####..##.##.#..#.###...###.#....###.#..#.#.#.##.#
#.#.##...###.###.###.#.#.###...##.##.....#.##..##...#..#......##..#...#.###.##...#.##.#..#.....#####
#...##.#..####..#.....##.#.#...#.#..#...##.##..###.#..##..###...#.....#..#...#.##.#.##..##..###.#.##
#..........#..#....#.#..#####.##...#....#.#.##..#####..#.#.#.#...#..#.###.#.#...###.#.#...#.###....#
#..#.###..#..#.###..####....##..#.#.##.##...####..#.#...#..##.#.##..##..#.#.##.###.#.#.#..###.#...#.
.#.......#.##.....###.#...##.####..##....###...##.#...##...#..##.#................###.#..........#..
..#...####....###....#..###.#.#....###...##.#..###....#..#..###...#.#.#..#..###..#..#.#..#.##..#.###
.#.#....#.##.....#.##.#.#.##.........#....#.#..###..#.#.#..#.##....#####.##.#..#.####.#.###..##...##
...#..######..#.##...#....#...#.####...#####.###.##.#..##....#..#......###.#.#..####.##.#.####....#.
..#....#...#..##..#..#..######..#.##....####.......#.##.#...#.#.#####......##..#..##.#.#####...#.##.
##..#.#...#..###...###..##...###..#..###.##.##..#..######..#.##....#.#..#.##..##..##.##.##.##..#.#.#
...#.##.#.#.#.#....#.#.##.##.##..##.#..###.#....####.##.#.##...###....#..#.#.......#.#..#...#...#..#
#.###....###.#####..##.#..#...###.####.##..#.#....##...##..#......#.#.#........##....##.#.....#.#.#.
#..#.....#....###..##.#...##...#...##....#..####.#..###......#...#..##.#.###......#....#####......##
##..#...###.###.#..#.#.#..#......#.#.###..########.#..###..#..#..#..#...###...#.#..###...#.###.#..#.
####..########....#...#.##....#..##.#....#..#.#.#...#.#.....#....#.#...#.....#.#.##.###.#.##.####.##
#.#.....#.###.....#..#..#.########..#....#.####.#.##.###.#...#..#.#.##.#...#...###..##.##.###.#.#...
..###..#....##.####.#..##..........####..###...#.##...#.#..##...#..##...#.....####.#....#..#...##..#
.#..#...#..#..#..#...#####..#.###.#.#.........#.#..#.##.....#....#.#..#..###.#...####...##.#.#....##
.#.##......#......#.##..#.##.#.##..##.....#.#...#.........##..#.##.#.##.#.#......#...##..###.#####..
.#.....#.#.#...##...#.....#....#.#......#####.#.##..#.#.#...........#.##....#.######.#..#####..###..
###..##.#.##.#....#.####.#...#..#.#..#.#.####.##...##..#####...####.#..###.#.##...##....#....####.##
#...#...#..###.....#.......##...#.###...###.##.....#..#....#.#....####.#####..#..#.#.#..#.#.#.......
#.###.#...#.#...#.....#.....##.###......##.#...#####.#....#..#.###...##...#.#.....##...#...######...
....#...##....#.##.###.##..#....#..#..###.#.....#.#.###.......##.#....##...##.....##...#..#.#.#..#.#
.#..#...#.#..#..####.##.#...#...##..#.###.#.#..#....##...#......#.#.#.##.##.#.#...#.##......#.###..#
#.##.#.###.....#...########.######...###.###..#.###....#...##..###..###...#..####...##...##..#.##.#.
.#....##..##.#....##.##.....#..#.#....###........#...####.#.##......#...#.#####..###......##...##..#
#...###...#####..#.#.....##.#####.##.#.##.....#.#...#.##.....#.#.##.######...#....##.#.#.#.#.#..##..
.#.####.....#.#.##.#..##.#.#....#.#.#...##.##.#......###..##.##.###..##..#.##.####.....#####..#.....
#.#.##.#......#.........#..#.###..#..####....###..#.#.....#.#..##.#....##..##.....#####.#..##.#...#.
#..#...#.#.#.##.#...###..####..#.#.###....##.##.#.#..#.#...##.#..#..#.#....#...####..###..##...##...
#....#.#..#.##......###.......##.#..##.#...##...##.....##..#....#..#..##..#.##..#.##....###..#..#.#.
#....#..#.....#.#.....#....###.##...#....#..####...#..#....#.#.....###....#...#..###.#..####.###.#.#
.#.#####....###.#..###..#..#..###..###.#.....#..##.#####.###.###.####..#.#.##.....#......##.###.###.
#.##.#####..###....##.#..##.##.#######......#.#..#.##.#...#....#..####.#.#..#.##....#.##..###.#....#
#...#.##.##.......#.######.##..#..#..######..###..##......####.##.#..##.###...#.##..#.##...#.###.##.
###.#..#....##..##....#####...#####.##.##...#.#....##..#.##....#.#.##.....#..#...#.........#...#.#..
.#....#.###..#..###.....####...########.##.#....##..#..##...##...###..#..#.##...##.###.###....#..#..
.#..#....##...#..#.###...###.#....#..##.##.##.##.#.###..##.##.....#.###.####.#..#.......######.##.#.
##.#.#####.##.#..#.#...###......###..##.......#...#....#....##.#..#####..#.#........#.##.##.....#...
.##.###....#.....#.#...####.#.#..#..#..##..#.##.#...#...##.#.#.........#..#...#..#....#####..##..#.#
..#.#.#..........##...#.#.##..####...##.###......##..##..###.##.##.#.###..#...#.#.....#......#..#.#.
..#.###.##...#.#.##.##########....#.##..##.#.##...#.#..........###...#....#..#..#.#######..###.##...
...#....#....#.....#.##..##..###....#....##.####.##..######..#####.#...##......#.#.....#...##....#..
.##.#..##..#####.###.....#.#...##.#..#.###.#####.##.#.##.#..#.###...##.###.####.#..##.##..#.##.###.#
####..#.#...#..#.##.....#..#...#......#.##.###..##....#.##.#.##.###...#####.##..###.#...####.#.#..#.
.#.#..##...#.#.#..#.#.####.##.#....#.#..#.##.......#...#...#.....##..#.#..##.#....#....##.##..##..##
.#.##.########..##.#..##.##.#....#.##...#....##.......#..#.######.######....##............#.#.#.#.##
.....##.######.##.##.....#...##..##.#.......#.#.##..#....##.#..##...#...#.##.....##..###....#.###...
#.##.#...##.#.#.#.###..#.#...##...####..####..#..##..##...#..#.#.##...#.##...##.###..#...##...#..#.#
.#.#..#.....#.#.#...##..##...#.#..#.#.#.#.##..###.#...##.#####.####.##.#...###..##...###..###..#.##.
.#.###...##..#.#..##...####..###.#.#..#....#.#######.#.###.##.#.#.#.#...#...###...#..#.#.#..#.#...##
.........#....##.#..#...#....####.#...##.#..##....##.#.##.###....##.....#...#.###..#.#.......##....#
####.......#...#.##......##..#....#.###..#..##..#.#.##...#.#.#....#..#.#...#..#.##.###.#..###.#.....
....#####.###..#....#.#.##.....#..#..#.###.......##.......##..#.#..#.###...#.#...#..#.#..#.####.###.
#..#.##.######..#..#....##....###....#.###..#.##..##.##....#.#..##.#.....##..##..#.#..#..#.####..##.
.###..###.#..#.##.......##.#..........###....##.#....##..#.##..###..#..#....#..#...#......#..#......
###.##...###.#...#..##....#....##.##.#.##.#.....###.##.#.##....#...#....###.#...#.#.##...##...#.....
...#####...#..####.##..#...#.##.#...#.#..#...#.###.#......#...#.##..#..#.##.#.##..###..##..####..#.#
...#...###...#.#######....####.###.#..#####..#.#.#......###..#....#.#.##.###..#.##.#..#...#..###..#.
..##.###.#......#.##.##...##..#.#.##..##..###......##....##..####.#.#.#......#....#..###.#.##.#.##..
#....#..##..#.#.....##....##......#.#.#....#.###.#..##.###.#.....###.....#.#.#...##.#....##...#...#.
.##.##..#..##..##.#..###.....#....##.#.....#...##..#....#.###.#..#.####.#.##.##..##.###.##.#.#####.#
...#.##.###...#.###....##.#.##.#.##....###...####.##...###.###.##.#..##.....#...#...#...##...#......
...###.#.#.#.......####..###....##..#...#...#.........#....###...##..##....#..#..##....#..#.#.#...#.
#..###...###.#..#.#.##.....#........#.#...#...#...#.##..##.......###.#..#.#........#..##...##....##.
.#..#.#.#.##..##..#.....#.##.#.#.#.........##....#..............#...#.#.#.#.#..#...#...#.###.#####..
###.##.....#....#...#.#..##.#.#...#..####.#...#.##..#.###########...#.##.##.##.##.#...######.#.##...
#....####...#..#....#......##..####..###.#.#...##.##...#.##..#..#..##...##.###.#.##.##....#.....#.#.
#.#.#.##....#.#..#.###..##.######..#..##...#.###....#....######...######..##.#.#########.#...#####..
#...#.#.##..##...######....##.###..####.##.##..####.#..##....#...###.#..##.###.##...###.....#.#.###.
..###..###.#.#..##..#..#....##..###.#..#..#.###.##.....##...#..####.#.##.#...###........##.###..##.#
..###.#...#.....#.##..#.###.###..#...#.#....#.......#...####..###...#.....#....###....##.......#.#.#
####..##...##.##.#.##....#.###.###.###..##..##...#..###....######.####..#..#..##.......##.#..#..#...
.#......###..##..#..##.#..#...#..#..###..#..#.#.###...#...#......#..#.##.#...##...###.#.##..#.#..#.#
.##.##...#..#......###.........#..#.#......##.##.....##...#.....#...###...#...#..#..#..#.#..##..#...
..###.##.......#...#.##..#.#....#.#...#..##...#..##..###.#.#..#...####..#.##.###.##..#....#..##..#..
...#....#.###...##...#....##.#.....#.#####.....#.##.###.###.##.....#..##..........#.##..#.#...#.#.##
##..#.#..##..#...##.####.....#.#...#..####.####.......##..#..#..#..##.##.#.##.#.##....###...#.##..#.
#..##..#...#...#.......#..##.##....#...##.###...#..#.#..###..##.#...###.#..##.#...#.###..#..#....#.#
##...##...#.##..#..#..#####..#.####.##.####.##.#...##..#.###.........#.##.####.##....#.#.#...#..##.#
