#.##.....#...#...#..##.##...#..##.#..#....#.#.#####.#....##....#....#####.....##...#....###.#..#.#..
#.#..#........##.#..#....###.#.#.#....##.#.....#....##...##.#..#.###..#..#.#.#....#...#.#....###...#
..#.....##..#.#.#....##...#.#.##.###....#.#....##..##.#......#.##..#.#.#.#...#.##.......#..#.....###
#.##.#..##.#.....#####.###..##..#....###..#####..#..#..#.#.....##...#.#...#...##.#......#.....#...##
#.##.###.#.##..#...#....#..#.#..#...#.###..#.#...#.#..#.#..#.#...#.##..##.##.#.#.#.#.....#.#.......#
.#.##...#...#..#.###.#....#.#.##.##.#.#.##........##....#.###.##.####.#..#....##.##..#.#.###.##...#.
..##.#####.####..#####..#.#.##.##.#.#.##..#.#..##.##.#.....###.###..#.#...##.#.#..#.#.###..##.....##
.#.#.#...#######......####.#..#..#..##.#.#....#.###.#....##.......#.##.#..#.#.###.##.##..##.####.#..
###....###..########...#..##.###.#.###...#######.#.####.#..##...###....##..#.##.###.####..##.##..#..
..#.......###.#..###.##...#..##.#.#..#...#.#....##..##.##.##.#..#..###...#..#.##..#.....##..#...##..
..##......###.#.##......#.##.#..##..###.......#..#....#....#..####..###....#...#.##.#...###..###..##
.###...##..#....#.####..#...##.#...#.###..#.##..#..........##.##...####..##...##.#.#.#.##.##.#..##..
.....#.#.#....#..#####.#.##..#..##..#..#.#.###.##.#....#...##....#..#..####..#..###.##....#.#.#.##.#
...###....#.#.#..####..##...#..######....#.#...#....#####.#.#.####..#....###.....###..###.....###.##
.##..#...#...#########.###......#..........##..##....#...#..###..##...#..##.#.#..###..#.##..##....#.
.####.###.....#.###...#......#..#.#..#####.##..###...#...#####.####..#...#..#.###.#...#.....#.#.....
..##.#.....##..#..###........#.#####....##.#.##.#.#....#..#.##..##.#...####.##..#.##.#..#..##.#.##.#
#.###.##...####...#.#.##.#.#...#.#..#...#..#.###.##......#.#.###.##.#.#................#.##.#.##.##.
###.#.##....#.####.#..##.#..#.#...####..##....#.....##.#...##.#.#.#.#.####.....####.###.#...#.##....
###..#####.##...#.###.#...###...##.##...##.....#....###..###..#.##..##..##..#####..##..#...###...###
###..##.###..#.##.#.#.####...#####.##..###.#...#.....##..#.#..######.#......#...#.##...#.###.#.#....
....##.#.#....#..#..#.#.#....#...#...#.#.#.##....##.#..###.#....##....#..#.#####.##.#.#..##.##.####.
..##########.##.....##.##..##..#.#.#.##.#.#.#.##.####.#..#.#.#.#.###.##.#..##.....###..#.#..###.#..#
.#...........#....#...#.#.#...##..#..#..##.#.#..##.........#.......#####..#.#..##.##..#...##....####
..###.#.#..#...##.....#.###..####..#.##..#...#.#..#....###..###.#.......#.#..##.##.#.#..#.#.#....#..
#######..###..##.#.###.#.......#..##.###.#..##.##.#..#....#.#...###.#...#..##.#..#.##...#...#.#..#..
......#.#..#####......#.##.#..#.##.#.##.#.#.#.#.#.##..#.#...##...#..##..##..##.....#.###.....#.#..#.
.#.##.#..#.#.##....#.##.......##......#.####..#.#.....#.###.....##.##.....##.#.......#.......#.##..#
####..#.##.#...#.#...####..###...#.#....#..#...#.###...####.#..##.#.####..#...#.#.#...#.##.###.#..#.
####.#..#.#....##...###.#...#.#.#...##...#.#...###.#.#..#.......#..###.##.......####.....##.###.....
..##.##.#.###.#..##..#..##.##.#...#..#...##..###...###..#.#....#.#.###...#.....#.##..#..##.##...#.##
.####...#..##.#.##.....#.##.#..#..#.#.##.###.#...#....##....##..#.#.##..#.....####.#.#.#.#.....#####
##..####.#.##..##..##.####.#.....#..#..######.###.#.####.#.#.#..#.#.#.###.##.....####.###..####.####
.#..#..#.##.###.#####.###....#.##.#.#.#....##.####..###.#.....#.#.#.#.#.#.##.#....#.##.###.#######..
##..#...#.##.##.#......#...#.....#....#.....###.#######.##.#..##.#.#..####..#.####.#..#...........#.
.#.#.####..###.#..#..##..##.#..#...##......#.......#.####.#.#..##.....##.#...##..#..##.#......#....#
.....##....#.######.#...##..#..####..#..#.###....##.##....##...#..#..##..#...#####..#......#..#.....
...#.#....#..#..####...#.###....##..#.###.....#.#.#...####..#####..#..##..####...#......###.##....#.
#...#.####.#.#.#######.#....#.#.....#..#.####.##...#.#....##.##.#.#.##...##.##.###...#..#.##..##...#
#..######...#...##...#.#.....#####.#.....##......#.###..#.#........###..##.##.##...#.##......###.##.
...#..#.#...#..#.##...###.#.......#......#.......##..#.#..............#.#####....####.####.#.#..###.
...#....##.##.#..#.##...###..##....#..#.######.....#.###.###..#######.......##.#.##....#.###.##....#
#.#....#.#...##.#..#.####.#.#......######...#.###......##...##...#......###......###.#.#..#..####..#
..#.#####..#...#.#.#.##.#..#........##..#..#..##.#..####.#...##..##..#...#.#.....####.#.....#..#....
....##.....#..#.####.#...##........##..###....#...#####....#.#.#.##...###.#......#....#.....#.##.###
####.#....#....#..#.###..##.#...###.#.##......###.####.##.#.....#...#.#####.##....#...##....#....##.
...##.###..#.#....#.#.#.#....#.#..#.#.#..###..##.#...#......#..##.###......#...#####.##.#.#....#.#..
##.##.###...#...##..#..#.#..#...#.....#..#..#.#.........#.##......#..#..##...#..#..###..##.##.#...##
....#..#...##..###.##.#.#.##.....#.....#..#.......###..###.##.###.#..#..##.#..##.#.#.###..#.#.##..#.
.##...#.#.#####....#####..##..#.....####..#.#.#####.#.#...#.......##...#...#..#.#.####.#.##..##.#...
###.#..###..#..###.#.#...#.........##.##...##.#####.###.#.#..#.#....#.###.#.##.....#.#.#.....#..#.#.
#..##.....###.#....###.##.#..#....#......#...#.#.##..#.#..#....#.###....#..####..##.#.#.#...##....#.
##...#..#.##.#...#.#...##.#...#.###.##.###....#......#..##....#.##....###..###.#....#.#...#.#####..#
#......#..#.##..####..###.....#........#.#.#...#...####...#.#..##...#.##..#...#..#...#....#.#.#..###
..#.#....#....####..##....###.##.#....#.......#...###.......#..............####.#..#.#.#.....###.#.#
##.#...###...#.#....###.#.#####...#.####.#.....##..#.#.##.......#.##...#.#.#......#.##......#.#.###.
#####.##....####..#..###.###...##..#.#.##...###.###.#.##.#.#..#..###....#...#..#..#...##...#.##.#...
..#....#.##.#####..#.#.####...#.##......###..#...#.##.##...###.#......#..##.#...#.#.#....##.###.....
.##...#...#..#.#..#..##........#........###....####..#.......#.###.#.#..##..##.....##.#..#########..
...#..#.#...##.#..##.#.##.##########..###.#.####.#.#.####.#.#.#.#...#.#..###..#..#.......#.##..####.
###.#..##.##.##..#.#..##......#..#...##########.#..###.#...#.##..........##..#.....####.##...#.###..
.#...#...#.##.....###.#..#####.........#......#####.#.#....#..#.##...###..#.#####..#.##.#...#####..#
.#.##..#.#.####..#...#.#.#..####.#.###..####....#.##.##..#..##.####...#...#..##..#.##..#..#....###..
#.#.##....###..#.#.#..#.#...##..##..###.##..#.##.#...#.#..####.##.##.#.....#....##..#.#......##...#.
.###.#####....#.....#...#.#.....#.##..####...##..#.##..###..###.#....#...##..##.###....####..#.#..##
..##.###.###.###..#.....##......#.#.#.#####..#...###...#.##.#..###.#...###.##.###....#.#.#...#.##.#.
#.......#..#####..##.......#..####..##..#.##...###.......#.#...........#.#.###.###..##.##.##.#...#..
.#..#...#..###.###.....###..#.#.####...#........####.###.###.#..####.#.#.###.......###..#...#.##.#..
#....#...##.#...##....#....##########.####..##.###...#..###..#..#.###..#.##.###.......##..###..##.##
.###..##.######.##...##.#...#.#..#.#.#.##.###.###.#.#.#...##.#...#.....#.####...........#..#.##..##.
...#.##.##.#...#.....####.###..#####..###.##.#.####.#..##.##.......#...#.##.....####.###...##..###..
##.##.....#.#.#....###..##.#............##..###...#.#......##.#.#####..#.###.##..#..####.###.##..#.#
..#..#.##........###.##..........##..#..#.#....#.##.#..##.##..##........#..###...#..#...##.#..#.##.#
#####..#.##.##..........#####.#........##..##..#...##.##.#..##....#.#######..##.#..#.#..#.#..####.#.
..###.#.####..##.###.####.#.####.##...###..###.....###.##.#.#.....#...#..#.######.###.##.##..######.
#..#.#....######..#..###...##..#.##....##.....##.##.....#.#.....###...#######.#.#....##.#..###..##.#
#.#.#.....##..#.####..##.##...#.....#..#....######.###...###.......##.#....#.#####.....#.#..#.#.####
....#...##.#..#....#....#...###.#..........#........######...#..#.#....##.......#..#####.#..##.#.#..
#.##......#######....#.#....#.##..#.##..#.##.##..#...#....#..###.#....###.##...#..##....#.#.#.##...#
###...#####.#.......#####..#.#.....#.###..#####..##..####...##...##.....#.#.##..###..#....###.#..##.
#......#..#..#####..##...#.....###..#..#.###..####.#.#.##.....##...##..#.###.####.##......###.....##
..##......#...#.#...#.####.#.#.#.##.#.###...#.#..#..#..#.#.##.#.##.#.#....#####.#####..#.#.#####.#.#
#...#.#.##......#######....#..#.####.#.#.#####...##.#..#.##.#....#.#.##..#.###.##...####.#.#.#......
.#.#.....###..#..#.#.##....#.#.#......######....####.......#..#.#..##..#.#.#####.#....####..#.#..##.
..#...#...####.#.#.###.#.###..#....##.#..##.###.#..##.##.#..#.##.####..#.#...##...##.#..#####.#..###
...#.##......#.........####...#....#.##..##..#.##....#####....###..###.#.#.#....####.#..##.#.###.#.#
.####.###.#..#####..#...##.#..#....#..##.....#.##.#..##.#..##...#..#.##.#.#.#.##.#.###..##.#.#..#..#
#...###.##..###.#.#..#.###.#....###..###.####.####.....##..#...####..#####..#.##...#.....###..#.##..
###..#..#.###.####.#.#.....#..#.#.##......#.##.##..####.##.##.####.##.....##..#.#.#..#.#.#...##..#..
........#.#..#.......##.####.##.##.####.........###....#....#...##.#..#....#...#####.#.###.##.##..##
#..#...####....######..##.#....##.###.#...####..#..###.....#....##.######...#.#.#....#.#.###.##.#.#.
....######..#..#..#.#.#.##....##.#.#...#.#....#....##.#............#.#...#..##.#..###..##..###.##...
#.#.#..#.#####..##..#.#####.#..##.#.#...#...###...####..#.##....###.#.##..#...#..#.....#.#####......
..#.##..#..#..###.....#....##..#...####..#.###.#.#....#...#####..#..#.##.#####.###...#.#.###..####.#
.#...#.#.#.#..###.###..#...##...#.##.#.##.#####.#..#.###..#.#..#.#.#####.##.###.#.........##.####..#
.###....#.#..#...#.....#.#.##.#..#.#.......##.#..#.##..###..#.#..#..#.#..####.#.#.#.#..#.#.....#.#.#
......#..##..##.#..###..#######.....###.#.#..#..#..#...#.......###....#..#..#.....#....#.#.....#.#.#
..##....##....#.#....#..####.######..##.##...#.#.....##..##.#..#.##..#..#.#....#.##.#......######.##
.#.....##....#..#..#....##.#####.###..###.#.#.#...#.##...#.#...###.##...##...######.#.#.##.##..#..#.
##.#..#......####..#.#####.#.##...###.#####.#.#.#.########..#.#..#......########.#.....#..#..#.#.#..
