.##...#..#......##.##...##..###.########.#.#..###..###.#.#....#.##.#..#####.#..#.######...####.##..#
...#.#.##...##..#...##..#....#.#.#..#.##...#..#..#.#..#....##.#...##..###.##..##..##.#...#.##..##...
...#..##.#.#...#..##.##.......#..##..##..###..#.#...........##...........#.#.#.####.##.#.##......#.#
....#...###...#######....#....###...#....#.#....#.#.####.....##.###..#...#.##.#####..#.#.#.###..#...
##.#.#..##...##..#..#.#.....#####..##.###.########.#....#.###.#....##....##.#..#...###...#####.#....
#.###.##.##.##.##.##.#.....#..#.#####.##.##.#.##..#...#.......#..#.#.##.##..#.##....#.####.#.##..#.#
.#....##..####.#.###.##...#..###.##.###.##...#..####..##.#.##..#.#.....#..#....###..#..#.#..#.......
..#..#...#.####.#..###..########..#####..##....#..##..#.##.#.#.....#.#..#.#...####...#...#...#.#.#..
..#...#.#.###.....##.#.#.##.#...#....#.#..#..###..##.##.####.#..###.....#..####.#.....##..#.##......
##.##.##.#.#.#....#.#..###...#.##.#.#..#..###..#####....#..##.#.#..###.###....##....#..##.#..#..#.#.
###..#.......#..##....#....#...#...###..#.#.......#...#..####.#.#..####...#.#.###..#..#.#..###....##
#...##.....####..#.####.###.#...#..#.##.....#..######.#...##.##.###.....##..#.#..#.#..#...#....#....
..#####.##..#.##.##..#..###..#....##.......#.##.####..####...##.#...###.#....##...###..##.##..#.###.
#...##.....#...#.####....####..#..#.##..#..#.#.#.#.#..###...###.##.......#..###..##.#....#.#.#.#.###
.....#....##.#.##.....##...#.###..#.######.###...##...######...#....##..###..#######.##.##.###.#..##
...#.####.....#...##....###..#.######.##.#.......###.##....#.######.##....#.#.#.##..#....#....######
....#.##....####....#.##...###...#.......#.##..##.##...#..#.....####.#.######.###....#.#....#######.
...#.......#..#..####.#........#...###.##.#..##.#.#.#.#...##..#.####.##.#....#..#.#..##..#..#......#
.###.#.....##.##..####..#.#.#.#..##.#...####...######......#..#...#.##.###.......#.#.###.##...#.####
###.#.....###..#.###.##.######...##.##.##...#..#.....#.##.#.####..###...###...#...#.##..#.#....#.#.#
#.....#.#.##..#....#..#.##.##.....###.###..#####...#...#.#..#.##.#.#.#..##.....##.#.##...#..#.#.#..#
##..#...#..#.#....#..##..###..#....##.....######.#...#..##..##..####............#..#..###.##.#.....#
#...#......#..##......#....#.###..##...##....#.########.##.##.#.#...#.#.#####.#...#.#..###.##....#.#
.#.#...##.#..#.#.#..#.##..###.#.#.###....#...#.##.##.#.#.#..#...#.#####.##...##.##..#......#...###.#
.#####..#.##..#..#.#.##..#####......###.#..#.#.##.###....##...##.#.#...####....##.#.##...###..###...
.###....#.#..##.##.....#.#..#..#.##..#.#.#######.##....####.##..#..#.#..#........##.#.....#...#..###
...##.#.##..##.#.#.#..#######...#..#####..###.##..#.#.###....#......#.#..####.#.####.#.#...#.......#
.#.#...#..#.#.#......#.....######...##.#..###........#..##.#.#.#.#...........#...#..###...###...##..
...###.###.#..#####.#.###..#..#.####.......##..#.###..###.##.###.#...##....#.##.#.##...##..###.#.##.
#.#.....##.#.#...#.....#####..#.#..####.#.#.#..#.###.#.#.#.##..#.##.##.#..#.###.....#..#.#.##.#.....
...#..#....###.#..#####...##.#..#.#.....##...##...#.#.#.#....##.#.#.#......#.#.#..#.....##.#...#....
..##.###.######.#..#.##..#.#..##..##.#.##.##......##..#..#.###...##.#...#.##......#..#...#.######.#.
#..#...###.......#......#.#....####.#..##..#..###..#..##.#.....#.###...#.##.#.......##.#.####.....#.
.##....#..##....#.#..#..#..#.##.#####.#....#.#.##....##...##...#.#...####...#..#..##.##....####..#.#
..#####.####.#.#.#...#.....##..#....###.##...#...#.....#...##..#.####.....#.#..####.#####.###..#.#.#
##.#.##..##..#.#.....#.....#....#.#..##..#.#.##....##..#..#.#...#.#..#.##.....#.#####..#.....##.#.#.
#....#..#..#...#.#..##########....##..##...#...####.......#..##..##.###...#..#....#.##..###...#..###
#####...#......###.###...#.##.##.#..#...#.##......###....##..###.#..##..#.#..###.#.###########..###.
#.#......#..##..##.##..#...#...##..#.#..##.###..##.#...#..##....#.........#...#.##.#.###..#.#.#...##
#.##..#..###......##..##..##.##..#..######...##.#.#.#.##...#.##.#.#....###...#####.##.###.....##.###
......#....##....##..#..###.##..###..#.#..#.##.#..#.##...#..####.#....#..#.###...#.#..#.#.#...#..##.
.#..#.#..#...#####.##....####.###..#....#.#.#....#.###.######.#.##...#.###........#.##.#.#.......#.#
##.###.#..#.#.#.#...##...#....###...##..##..##.....##.....#.##...###.#...###.#..#...#........##.##.#
.##..##.#.#.##.#..##.###.####....#..##...#........###....##.##.####..#....####.....##.#.#..#..##.##.
###..####.....##...##.###..#.........#.##.##.#......#..#..#..##.#..####.###...##...####..#.#######..
##..#######...#####.#############.#...##.......##...###..##..##.....#......###.....######.#..###..##
.#..##..#.#.....#...###.##..#...##......##...##...#.##...##..#..#......#####.###.####....#.###....#.
#.....###..#.#.####.#..####.....##.#.#..##.#..#...#.#....#....###.#...#.#..#...#......###...#...###.
.##...#.##..###..#.#.###.#.....#..##.###.#.#.......##.#.#.#.#...#.#.#.#.###.##.#.#....###.######....
...#...####....#.####.####...#.#..#..###.##..##.####.#.###...#.........###.#.##.##..#.#.###.#......#
####..#.#######.#.#........#..#...##.####..#...###....#.....#.#.#...#..#......#...#..#.####.##....##
...#...#...#.#.....##....#...#..##.....#.#..#..#..#.####.#...#.#...#.###..#.#.#..#.#......##.#...###
.#.#.###.##.##.##.####..#....###.##.##.#...##.#.##.#..#...###.#.#..######..#.#.#..#....#.###....###.
.#######.....##...##..###.#...####..#.##.##.#..#..#####....#####.##.#......##.#....#....####.##....#
..#...##.#.####.##.##.####..#...#..##.####.#...##.##..#..#...#..#.#..#.#....#.##.#.####.##...#.#.#.#
....#..#..##...#.###.#..#....###.#....###....##.....#..#...###...#....#..###..###...##...##..#.#.#..
...#...#..#....##.#..##..##.#.###...###...#...#########...#...#.#.#....#.#.#.#.#.#..##..#..##..#..#.
#..###....#..#.###.#.....#....#...#...#.#.##...#.###..#.#.##...##..#.###..#.#.#.##.##.##.#.#.#..####
....##.#.#####.##...#..##..#..#.#....##..#..#.###.#.#..#...#.##..#.....#######.##...#..#...#...#.#..
#.###..#....#..####.......##...###...........######..#.#..#.###..###.#...##..#...###.#..#....##.##..
.###....#..###.#..#.#......##..#.##..##.#..#..##...##.##....#.#.#.###..#...#.#.#.....##....#...#....
#.#.#..###..#....#.....###...##..#.##...#.####....###...##.#.#.#.#.##.#.#.#..#..###.##.#.###....###.
...#.###.....##.#.#####...##.####............##.#..##.##.##...#.#..#..#####.#..#....#..#..#.#...#.#.
.....#.##....##....#.#.###...##..#.##..#.###...##.#.####.#.#.##.##..#....##.....####..#.#.#.#......#
.#....#...###.###...#.#.#.##.#..#.#.###.#..###..####.#.#.#...#..##.#..#..........##..#...#.#.#.#.#.#
#.#.##..#..#.#####...########..#..##.#.#..#..#.#.#..######..#.###....##....#...##.#.....#....#......
#.###....#.##.#..##..#.#.#.#.##..#.#..#......#.####.....####...#...#..#..#.#..##..#...##.#..#..###..
#......##.#....##...#.##..####.#....#...#...#..#..#......###.##....###.##..#..##.#..#...#.#.#.#..#..
##...#...#.#..###.#.#......#..#..#....#..#.#.#..#...##.#.#....#..####.#.#...#..#.###..#....#..#...##
..#..#...#.#.##..##.##...####..#...#.#.#....#...##..###......###..###...##.#.####.###.....########.#
#..##..##.....#.##....##.##..##..##.###.#..#####.....#.......#..#.....###..#..#..##.#.....##..#.#...
#.#..#...#.##.##....#...##..#....#.##.#.##.#....###..#..###....#.#..#.#.#..#......#...#.#.##.....#..
#.#.....#.####...#........##.#....##.......##.#...###.....#..##.##.####.#.###.#..#.#....###.#.####.#
##.....##.###..#...###....#..#.##..####.#.#.##.###...##.....#.....###.#..#...###...#...#..##...#...#
#..#.##.....###.....#.....#.####.#....#######.#.##...####.#.##..#....##..#.##...#.#..##..#.#..####.#
###.#.#.##...###.#...#..#.....#..##..####.#.#..########.#..#####.#.###..#...##...###..##.##..####.#.
.#..##.#.##...#.##....##..#.......##...##..##..#...##.#..####...###..#....#..##.##.#.##......#....#.
.#..#..#.#.#.####....##.#..##.#..#..##.#....#..#..#####..##..#.#.#.#....#.#..##..#.#.#.#.##.#..###..
..#..#.....#..#.##..#.##.##..###..####.....####..####.###..##...#.##..###.#...#.....##.#...#.#..#...
#.#.#....#.#..#...#.#...#..#.#######..##.#..#.............#..###....####.#....##.#.#.###....##..##.#
....####...##..#.###.#.#...###...#.###...#..#.##.....#..#...##...#.##.#......###..#....##.#.##.##...
#.###..###.#.#.##.#..#.###.####.##.##...#.###.###.##.###..##.####..##.....###.##.#.........#..#.#.#.
#...#..####...######.#..##........######.......##....#......#.###.....##.#.##.###..#.####.####...##.
#..##....#.##.###.#..##...#.#......#.#.#....#....##.###.#.###..###.###...#.#....#.#..#..###.###..##.
....#.#..##.....#..#..#..##...#.#...##...#####.###...........#.######.##...#...#..#.###..#.##..##...
##..#..#.##......#....#..##.#.#..###.##.#.##......#..##.##...#.#.##.##...#.#.#...#..#..#.##.#..#####
.#...#...#....##..#####..#.#.#..#...##..#.##...###.#..##.##.#.#.##..########.##..#.#..#...##...#.#.#
..#..###.#.#....##.###.#.....#.#.##.#.####.##.......##....##.####.##.....##.#.#..#....#...####.##...
...##.##...##.#....##.#.#.##.#.#..##....#...#..#.#...#.#..#......#.#.#...#####..#..#.#...#.###....#.
....#....#..#.....##..#......#..#..#....#...###....#....####.##.####.#.#.##..##.#..#.#....###..#..##
####.#..###...#...#..##.....#.###..#.##..#.#.##.#####.##.###......##..###....#....##.##.#.##...#.##.
....#.#..#..#.##.#....#....#..#..###...#..###...#.#.......#..#.#...###.###.##.#..#.#...####...####.#
###.##..####..##..#.###......#.#.#.##..####.#..#...##....#.###.####....###....#..#...###.##..#.####.
#.###..#..##.####..##....###..#..######.......#.##.#.#...#...####..#.#.##..##....######...##.....###
...#.....#...#..##...###.#....##.#.##..##...##....#...#....##.........##.#..##.#..#..##..##.######..
.......##.##..#..#....####..#.#.#..##.....#.#.#...#..###.#..#######.##.#..##.......#....#..#.#.##..#
...........##..##........#..#..#.#......##.#.#..##....#.####..#.......####.#..#...####.....#..######
#......#.#..##.......#####..#....####..###.##...#.##.####..#....######..##..##....##..###..#.#..####
.#..#....#.######.##.#.....##...#.#..##......#.##........##.###....##...#...#.####.##...##.#.......#
..##.#...##.######.##.#..##...##..###.##...#..##.####.#.#.###...##.#...##...#.#....##.##.#.##.#.#..#
